Accurate Attack=Precision Attack
Air Blast=Gust
Arcane Marksman=Arcane Archer
Aura of Perseverance=Aura of Purity
Aura of Vivacity=Aura of Life
Expelling Smite=Banishing Smite
expelling smite=banishing smite
Battleborn=Warforged
Blade Dancer=Bladesinger
Blade Expert=Blade Mastery
Blade Barrier=Blade Ward
Blinding Smite=Blinding Smite
Block=Parry
Booming Step=Thunder Step
Bounden Ice=Rime's Binding Ice
Burning Blade=Green-Flame Blade
Burst of Radiance=Word of Radiance
Celerity Boon=Gift of Alacrity
Elemental Orb=Chromatic Orb
Circle of the Night=Circle of the Moon
Cleaving Attack=Great Weapon Master
College of Audacity=College of Swords
College of Guts=College of Valor
College of Valiance=College of Eloquence
Coordinated Attack=Maneuvering Attack
Crusader's Mantle=Crusader's Mantle
Destroyer=Crusher
Deadeye=Sharpshooter
Defensive Stance=Defensive Duelist
Diverting Attack=Distracting Strike
Divine Wrath=Destructive Wave
Earth Tremor=Earth Tremor
Eldritch Adept=Eldritch Adept
Elemental Enchantment=Elemental Weapon
Elusive Movement=Evasive Footwork
Elven Precision=Elven Accuracy
Enduring Sting=Sapping Sting
Entangling Strike=Ensnaring Strike
Ethereal Knell=Toll the Dead
Ethereal Step=Far Step
Martial Might=Fell Handed
Arcane Teleportation=Fey Teleportation
Summon Familiar=Find Familiar
Fire Arrows=Flame Arrows
Precognition=Foresight
Gambit Dice=Superiority Dice
gambit dice=superiority dice
Gambit Die=Superiority Die
gambit die=superiority die
Gambit=Maneuver
gambit=maneuver
Gambits=Maneuvers
gambits=maneuvers
Force Field=Gravity Sinkhole
Heavy Armor Expert=Heavy Armor Master
Heroic Infusion=Tenser's Transformation
Hunger of The Void=Hunger of Hadar
Incineration=Immolation
Inexorable Hex=Relentless Hex
Infernal Vitality=Infernal Constitution
Inspire Ally=Rally
Inspiring Leader=Inspiring Leader
Warden=Interception
Inventor=Artificer
Conducting Arrow=Lightning Arrow
Magic Apprentice=Magic Initiate
Magical Negation=Circle of Power
Intensify Gravity=Magnify Gravity
Grand Heal=Mass Heal
Medium Armor Expert=Medium Armor Master
Meteor Shower=Meteor Swarm
Dull Emotions=Mind Blank
Mind Skewer=Mind Sliver
Illusory Duplicates=Mirror Image
Nature's Shroud=Nature's Veil
Path of the Spirits=Path of the Totem Warrior
Pernicious Cloak=Cloak of Flies
Piercing Expert=Piercer
Polearm Expert=Polearm Master
Arcane Word Heal=Power Word: Heal
Arcane Word Kill=Power Word: Kill
Protector of the Wild=Guardian of Nature
Psychic Lance=Raulothim's Psychic Lance
Psychic Whip=Tasha's Mind Whip
Ranged Expert=Crossbow Expert
Readied Strike=Brace
Revenant Great Sword=Revenant Blade
Alter Gravity=Reverse Gravity
Royal Knight=Banneret
Infernal Smite=Searing Smite
infernal smite=searing smite
Overwatch=Sentinel
Umbra Touched=Shadow Touched
Transformation=Shapechange
Shield Techniques=Shield Master
Skin of Retribution=Armor of Agathys
Slashing Expertise=Slasher
Smith=Forge
Sound Burst=Thunderclap
Spear Expert=Spear Mastery
Spell Marksman=Spell Sniper
Spike Barrage=Hail of Thorns
Spirit Nimbus=Spirit Shroud
Nimbleness=Squat Nimbleness
Steel Whirlwind=Steel Wind Strike
Swift Strike=Zephyr Strike
Sword Storm=Sword Burst
Tactician=Battlemaster
tacticians=battlemasters
Psychokinesis=Telekinetic
The Soulblade=The Hexblade
Thorny Vines=Thorn Whip
Resonating Blade=Booming Blade
Booming Smite=Thunderous Smite
booming Smite=thunderous smite
Halt Time=Time Stop
Tomb of Frost=Tomb of Levistus
Vexing Hex=Maddening Hex
Vile Brew=Tasha's Caustic Brew
Vitality Transfer=Life Transference
Void's Grasp=Arms of Hadar
Battle Caster=War Caster
Weaponsmith=Battle Smith
Conjure Web=Web
Apparitions=Weird
Furious Smite=Wrathful Smite
furious Smite=wrathful smite
Provoke=Goading Attack
Knockdown=Trip Attack
Reach=Lunging Attack
Repel=Pushing Attack
Counterattack=Riposte
Switch Places=Bait and Switch
Threaten=Menacing Attack
Tactical Strike=Commander's Strike
Malakh=Aasimar
Swift Throw=Quick Toss